11111111211111111111111111111111111111111111111111111111111111111111111111111114
11111111121111111111111111111111111111111111111111111111111111172111111111111114
11111111112111111111111111111111111111111111111111111111111111172111111111111114
11111111111111111111111122222222222222222222222222222222222221111111111111111114
11111121111111211111211111111111111111111111111111111111111111211111111111111114
11811111111111122111111111111111111111111111111111111111111111111111111111111114
11221111111172111221111111111111111111111111111111111111111112111111111111111114
11211111111172111112211111111111111111111111111111111111111111111111111111111114
11211111111172111111122111111111111111111111111111111111111121111111111111111114
11211111111172111111111221111111111111111111111111111111111111111111111111111114
11211111111172111111111112211111111111111111111111111111111211111111111111111114
11211111111172111111111111122111111111111111221111111111111121111111111111111114
11211111111172111111111111111221111111111111121111111111111111111111111111111114
11211111111172111111111111111112211111111111121111111111111111111111111111111114
11211111111172111111111111111111122111111111121111111111111111111111111111111114
11211111111172111111111111111111111221111111121111111111111111111111111111111114
11211111111111111111111111111111111111211111121111111111111111111111111111111114
11211111111111111111111111111111111111111211122222222222111111111111111111122222
11211111111112222222111111111111222221111111222222222222666666666666666666622222
31266666666662222222666666666666222226666666222222266666666666666666666666666662
22266666666666666666666666666666666666666666222222266666666666666666666666666662
22266666666666666666666666666666666666666666222222266666666666666666666666666662
22222222222222222222222222222222222222222222222222222222222222222222222222222222