0
0
0
0
0
13111111111111111111111111111111111111111111111111111111111111111111111111111114
22222211112111111111111112222222222222222222111111111111122222222222222222222222
21111111112111121111111111111111222222222222111111111121111111111111111111111111
21111111111111121111211111111111111111222222111111111111211111111111111111111111
21111111111111111111211112111111111111111222111111111111112111111111111111111111
21111111111111111111111112111111111111111122111111211111111121111111111111111111
21111111111111111111111112111111111111111112111121111111111111211111111111111111
21111111111111111111111111111111111111111112111121111111111111112111111111111111
21122222222222222222222222222222222222222222111121111111111111111121111111111111
22111111111111111111111111111111111111111111111121111111111111111111211111111111
22211111111111111111112222222211111111111111111121111111111111111111112111111111
22221111211211112112111111111111121111211222222221111111111111111111111122222222
22226666666666666666666666666666666666666666666622222222222222222222222222222222
22222222222222222222222222222222222222222222222222222222222222222222222222222222
0
0
0
0