0
0
0
0
11111111111111111111111111111111111122111111111111111111111111111111111111111114
11111111111111111111111111111111111221111111111111111111111111111111112221111114
11111111111111111111111111111111112221111111111111111111111111111111112221111114
11111111111111111111111111111111122221111111111111111111111111111111112221111114
11111111111111111111111111111111222221111111111111111111111111111111112221111114
11111111111111111111111111111112222221111111111111111111111111111122222221111114
11111111111111111111111111111122222221111111111111111111111111111122222221111114
11111111111111111111111111111222222221111111111111111111111111111222222221111114
11111111111111111111111111112222222221111111111112222222111111112222222221112225
11311111111111811111111111112222222226666666666662222222666666662222222222222225
22222222222222222222222222222222222226666666666662222222666666662222222222222225
11111111111111111111111111111112666666666666666666666666666666666666621111111114
11111111111111111111111111111112222666666666666666666666666666666622221111111114
11111111111111111111111111111111112222222266666666666666666222222221111111111114
11111111111111111111111111111111111111111222222222222222222211111111111111111114
0
0
0