11111111111111111111111111111111111111111111111111111111111111111111111111111115
11111111111111111111111111111111111111111111111111111111111111111111111111181115
11112211111112111111111112111211121112111211121112111222222222222222222222222215
11112211112111111111121111111111111111111111111111111111111111111111111111111115
11112211111111111121111111111111111111111111111111111111111111111111111111111115
11112211111111121111111111111111111111111111111111111111111111111111111111111115
11112211111111111111111111111111111111111111111111111111111111111111111111111115
11112211111121111111111111111111111111111111111111111111111111111111111111111115
11112211111112111111111111111111111111111111111111111111111111111111111111111115
11112211111111111111111111111111111111111111111111111111111111111111111111111115
11112211111111211111111111111111111111111111111111112111111111111111111111111115
11112211111111111111111111111111111111111111111111111111111111111111111111111115
11112222222222222222222222222222222222222222222222221222222222222222222222222225
13122666666666666666666666666666666666666666666666666666621111111111111111111114
22226666666666666666666666666666666666666666666666666666626666666622222222222225
26666666222222222222222222222222222222222222222222222222226666666621111111111114
26666666266666666621111111111112666666666666666666666666666666666621111111111114
26666666266666666621111111111172666666666666666666666666666666666621111111111114
26666666666662666666222222222666666666666666666666666666666666666621111111111114
26666666666662666666211111112666666666666666666666666666666666666621111111111114
22222222222222222222211111112222222222222222222222222222222222222221111111111114
0
0
