11111111111111111111111111111111111111111111111111111111111111111111111111111115
11111111111111111111111111111111111111111111111111111131111111111111111111111115
11111111111111111111111111111111111111111111111111121122111111111111111111111185
11111111111111111111111111111111111111111111222211111111111111222222222222222225
11111111111111111111111111111111111111111111111111211111112111111111111111111115
11111111111111111111111111111111111111111111111111111112111111111111111222211115
11111111111111111111111111111111111111111111111111112111111111111111121111112115
11111111111111121112111211121112111211121112111211111111111111111112111111112115
11111111112111111111111111111111111111111111111111111111111111111211111111111115
11111111121111111111111111111111111111111111111111111111111111121111111111111215
11111111111111111111111111111111111111111111111111111222211112111111111211112115
11111111211111111111111111111111111111111111111111112111111111111121111111111115
11111111112111111111111111111111111111111111111111121111111111111112111111111115
11111111111111111111111111111111111111111111111111211111111111111111121111111115
11111111211111111111111111111111111111111111111111211111111111211111111121111115
11111111112111111111111111111111111111111111111111211111111112111211111112111115
11111111111111111111111111111111111111111111111111211111112111111121111111111115
11111111111121111111111111111111111111111111111111211111121111111111222222221115
11111111111111111111111111111111111111111111111112111111121111111111211111111115
22222222222222222222222222222222222222222222222222222212222222222222222222222225
11111111111111111111111111111111111111111111111111111111111111111111111111111115
11111111111111111111111111111111111111111111111111111111111111111111112221111175
66666666666666666666666666666666666666666666666666666666666666666666662222221114
22222222222222222222222222222222222222222222222222222222222222222222222222222225