11111111111111111111111111111111111111111111111111111111111111111111111111111112
11111111111111111111111111111111111111111111111111111131111111111111111111111112
11111111111111111111111111111111111111111111111111121122111111111111111111111182
11111111111111111111111111111111111111111111222211111111111111222222222222222222
11111111111111111111111111111111111111111111111111211111112111111111111111111112
11111111111111111111111111111111111111111111111111111112111111111111111222211112
11111111111111111111111111111111111111111111111111112111111111111111121111112112
11111111111111121112111211121112111211121112111211111111111111111112111111112112
11111111112111111111111111111111111111111111111111111111111111111211111111111112
11111111121111111111111111111111111111111111111111111111111111121111111111111212
11111111111111111111111111111111111111111111111111111222211112111111111211112112
11111111211111111111111111111111111111111111111111112111111111111121111111111112
11111111112111111111111111111111111111111111111111121111111111111112111111111112
11111111111111111111111111111111111111111111111111211111111111111111121111111112
11111111211111111111111111111111111111111111111111211111111111211111111121111112
11111111112111111111111111111111111111111111111111211111111112111211111112111112
11111111111111111111111111111111111111111111111111211111112111111121111111111112
11111111111121111111111111111111111111111111111111211111121111111111222222221112
11111111111111111111111111111111111111111111111112111111121111111111211111111112
22222222222222222222222222222222222222222222222222222112222222222222222222222222
11111111111111111111111111111111111111111111111111111111111111111111111111111112
11111111111111111111111111111111111111111111111111111111111111111111112221111172
66666666666666666666666666666666666666666666666666666666666666666666662222221114
22222222222222222222222222222222222222222222222222222222222222222222222222222222