11111111111111111111111111111111111111111111111111111111111111111111111111111114
11111111111111111111111111111111111111111111111111111111111111111111111111111114
11111111111111111111111111111111111111111111111111111111111111111111111111111114
11111111111111111111111111111111111111111111111111111111111111111111111111111114
11111111111111111111111111111111111111111111111111111111111111111111111111111114
11111111111111111111111111111111111111111111111111111111111111111111111111111114
11111111111111111111111111111111111111111111111111111111111111111111111111111114
11111111111111111111111111111111111111111111111111111111111111111111111111111114
11111111111111111111111111111111111111111111111111111111111111111111111111111114
31111111111111111111111111111111111111111111111111111111111111111111111111111114
22222222299999999999999992229999999999999999992229999999999999999222222222222225
11111111111111111111111111111111111111111111111111111111111111111111111111111114
11111111111111111111111111111111111111111111111111111111111111111111111111111114
11111111111111111111111111111111111111111111111111111111111111111111111111111114
11111111111111111111111111111111111111111111111111111111111111111111111111111114
21111111111111111111111111111111111111111111111111111111111111111111111111111115
26666666666666666666666666666666666666666666666666666666666666666666666666666665
26666666666666666666666666666666666666666666666666666666666666666666666666666665
22222222222222222222222222222222222222222222222222222222222222222222222222222225
11111111111111111111111111111111111111111111111111111111111111111111111111111114
11111111111111111111111111111111111111111111111111111111111111111111111111111114
11111111111111111111111111111111111111111111111111111111111111111111111111111114
11111111111111111111111111111111111111111111111111111111111111111111111111111114