0
0
0
21111111111111111111111111111111111111111111111111111111111111111111111111111114
21111111111111111111111111111111111111111111111111111111111111111111111111111114
21122222222222222222222222222222222222222222222222222222222222222222222222222222
22111111111111111111111111111111111111111111111111111111111111111111111111111112
22211111111111111111111111111111111111111111111111111111111111111111111111111112
22222222222222222222222222222222222222222222222222222222222222222222222222221112
11111111111111111111111111111111111111111111111111111111111111111111111111111222
31111111111111111111111111111111111111111111111111111111111111111111111111112222
22222222222222222222222222222222222222222222222222222222222222222222222222222222
0
0
0
0
0
0
0
0
0
0
0