11111111111111111111111111111111111111111111111111111111111111111111111111111114
11111111111111111111111111111111111111111111111111111111111111111111111111111114
11111111111111111111111111111111111111111111111111111111111111111111111111111114
11111111111111111111111111111111111111111111111111111111111111111111111111111114
11111111111111111111111111111111111111111111111111111111111111111111111111111114
11111111111111111111111111111111111111111111111111111111111111111111111111111114
11111111111111111111111111111111111111111111111111111111111111111111111111111114
11111111111111111111111111111111111111111111111111111111111111111111111111111114
11111111111111111111111111111111111111111111111111111111111111111111111111111114
11111111111111111111111111111111111111111111111111111111111111111111111111111114
11111111111111111111111111111111111111111111111111111111111111111111111111111114
11111111111111111111111111111111111111111111111111111111111111111111111111111114
11111111111111111111111111111111111111111111111111111111111111111111111111111114
22222222222222222222222222222222222222222222222222222222222222222222222222222222
11111111111111111111111111111111111111111111111111111111111111111111111111111111
11111111111111111111111111111111111111111111111111111111111111111111111111111111
11111111111111111111111111111111111111111111111111111111111111111111111111111111
11111111111111111111111111111111111111111111111111111111111111111111111111111111
11111111111111111111111111111111111111111111111111111111111111111111111111111111
11111111111111111111111111111111111111111111111111111111111111111111111111111111
11111111111111111111111111111111111111111111111111111111111111111111111111111111
11111111111111111111111111111111111111111111111111111111111111111111111111111111
11111111111111111111111111111111111111111111111111111111111111111111111111111111
