11111111111111111111111111111111111111111111111111111111111111111111111111111112
11111111111111111111111111111111111111111111111111111111111111111111111111181112
11112211111112111111111112111211121112111211121112111222222222222222222222222212
11112211112111111111121111111111111111111111111111111111111111111111111111111112
11112211111111111121111111111111111111111111111111111111111111111111111111111112
11112211111111121111111111111111111111111111111111111111111111111111111111111112
11112211111111111111111111111111111111111111111111111111111111111111111111111112
11112211111121111111111111111111111111111111111111111111111111111111111111111112
11112211111112111111111111111111111111111111111111111111111111111111111111111112
11112211111111111111111111111111111111111111111111111111111111111111111111111112
11112211111111211111111111111111111111111111111111122111111111111111111111111112
11112211111111111111111111111111111111111111111111111111111111111111111111111112
11112222222222222222222222222222222222222222222222111122222222222222222222222222
13122666666666666666666666666666666666666666666666666666621111111111111111111114
22226666666666666666666666666666666666666666666666666666626666666622222222222222
26666666222222222222222222222222222222222222222222222222226666666621111111111111
26666666266666666621111111111112666666666666666666666666666666666621111111111111
26666666266666666621111111111172666666666666666666666666666666666621111111111111
26666666666662666666222222222666666666666666666666666666666666666621111111111111
26666666666662666666211111112666666666666666666666666666666666666621111111111111
22222222222222222222211111112222222222222222222222222222222222222221111111111111
0
0