11111111111111111111111111111111111111111111111111111111111111111111111111111114
11111111111111111111111111111111111111111111111111111111111111111111111111111114
11111111111111111111111111111111111111111111111111111111111111111111111111111114
11111111111111111111111111111111111111111111111111111111111111111111111111111114
11111111111111111111111111111111111111111111111111111111111111111111111111111114
11111111111111111111111111111111111111111111111111111111111111111111111111111114
11111111111111111111111111111111111111111111111111111111111111111111111111111114
11111111111111111111111111111111111111111111111111111111111111111111111111111114
11111111111111111111111111111111111111111111111111111111111111111111111111111114
11111111111111111111111111111111111111111111111111111111111111111111111111111114
11111111111111111111111111111111111111111111111111111111111111111111111111111114
12222222222222222222222222222222111112222222222222222222222222222222222222222225
21111111111111111111111111111112222222111111111111111111111111111111111111111114
11111111111111111111111111111111111111111111111111111111111111111111111111111114
11111111111111111111111111111111111111111111111111111111111111111111111111111114
11111111111111111111111111111111111111111111111111111111111111111111111111111114
11111111111111111111111111111111111111111111111111111111111111111111111111111114
11111111111111111111111111111111111111111111111111111111111111111111111111111114
11111111111111111111111111111111111111111111111111111111111111111111111111111114
11111111111111111111111111111111111111111111111111111111111111111111111111111114
11111111111111111111111111111111111111111111111111111111111111111111111111111114
1111111111111111111111111111111111111111111111111111111111111111111111