0
0
0
0
0
11111111111111111111111222222222222211121112111222222222222222211121111111111114
11111111111111111112222211111111111111111111111111111111111111211111111111111114
11111111111111122222111111111111111111111111111111111111111111211111111111111114
31111111111122221111111111111111111111111111111111111111111111266662111111111114
22222222222111111111111111111111111111111111111111111111111111222222111111111114
11111111112111111111111222222211111111111111111111111111111111111112111111111114
11111111112222222222222211111211111111111111111111111111111111111112111111111114
11111111111111111111111111111211111111111111111111111111111111111112111111111114
11111111111111111111111111111222222111121111111111111111111111111111111111111114
11111111111111111111111111111111112111111111211122222222222222222222222222222222
11111111111111111111111111111111112666666666666666666666662111111111111111111111
11111111111111111111111111111111112222222222222222222222222111111111111111111111
0
0
0
0
0
0