11111111111111111111111111111111111111111111111111111111111111111111111111111114
11111111111111111111111111111111111111111111111111111111111111111111111111111114
11111111111111111111122222222222222222222211111111111111111111111111111111111175
11111111111111111121111111111111111111111112111111111111111111111111111111111175
11111111111111111122222222211111111111111111121111111111111111111111111111111175
11111111111111111111111111222222211111111111111211111111111111111111111111111175
11111111111111111111111111111111222222211111111112111111111111111111111111111175
11111111111111111111111111111111111111222222111111221111111111111111111111111175
11111111111111111111111111111111111111111111112111111222111111111111111111111175
11111111111111111111111111111111111111111111112112111112111111111111111111111175
11111111111111111111111111111111111111111111111212111111121111111111111111111175
11111111111111111111111111111111111111111111111112111111122211111111111111111115
11111111111111111111111111111111111111111111222222111111111112221111111111111175
11111111111111111111111111111111111111112111111111111111111111121111111111111175
11111111111111111111111111111111111121111111111111111111111111111211111111111175
11111111111111111111111111111111121111111111111111111211111111111222111111111175
11111111111111111111111111111121111111111111111111111121111111111111121111111175
11111111111111111111111111121111111111111111122122122122111111111111111211111175
11111111111111111111111111211111111111111111111111111121111111111111111112111124
21311111111111111111111722221111111111111111111111111211111111111111111111111114
22222222222222222222222222226666666666666666666666666666666666666666666622222225
22222222222222222222222222222222222222222222222222222222222222222222222221111114
11111111111111111111111111111111111111111111111111111111111111111111111111111114